1111111111111
1000000000001
1000000000001
100A000111001
100S0001 1001
10000001 1001
10000001 1B01
11111111 1111 