11111111111
10000000001
10000000001
10000001111
100S0001   
10000001   
10000001   
11111111   